爆爆	一费卡	家人、极客、伏击专家
蔚奥莱	一费卡	家人、搏击手
德莱厄斯	一费卡	征服者、监察
德莱文	一费卡	征服者、搏击手
辛吉德	一费卡	炼金男爵、哨兵
斯特卜	一费卡	执法官、格斗家
麦迪	一费卡	执法官、狙神
莫甘娜	一费卡	黑色玫瑰、先知
拉克丝	一费卡	皮城学院、法师
阿木木	一费卡	海克斯机械、监察
婕拉	一费卡	试验品、法师
艾瑞莉娅	一费卡	蓝发小队、哨兵
薇古丝	一费卡	蓝发小队、先知
特朗德尔	一费卡	格斗家、极客
范德尔	二费卡	家人、监察
芮尔	二费卡	征服者、哨兵、先知
烈娜塔	二费卡	炼金男爵、先知
卡密尔	二费卡	执法官、伏击专家
弗拉基米尔	二费卡	黑色玫瑰、监察、法师
蕾欧娜	二费卡	皮城学院、哨兵
魔腾	二费卡	海克斯机械、迅击战士
厄加特	二费卡	试验品、炮手、搏击手
泽丽	二费卡	野火帮、狙神
阿卡丽	二费卡	蓝发小队、迅击战士
瑟提	二费卡	蓝发小队、格斗家
吉格斯	二费卡	极客、统领
崔丝塔娜	二费卡	炮手、外交官
斯维因	三费卡	征服者、双形战士、法师
荏妮	三费卡	炼金男爵、格斗家
史密奇	三费卡	炼金男爵、伏击专家
洛里斯	三费卡	执法官、哨兵
崔斯特	三费卡	执法官、迅击战士
卡西奥佩娅	三费卡	黑色玫瑰、统领
伊莉丝	三费卡	黑色玫瑰、双形战士
伊泽瑞尔	三费卡	皮城学院、蓝发小队、炮手
克格莫	三费卡	海克斯机械、狙神
布里茨	三费卡	海克斯机械、统领
努努	三费卡	试验品、格斗家、先知
刀疤	三费卡	野火帮、监察
普朗克	三费卡	极客、双形战士、搏击手
娜美	三费卡	外交官、法师
安蓓萨	四费卡	征服者、迅击战士、外交官
蔚（四费）	四费卡	执法官、搏击手
库奇	四费卡	炮手、极客
希尔科	四费卡	炼金男爵、统领
伊利斯	四费卡	黑色玫瑰、双形战士、格斗家
黑默丁格	四费卡	皮城学院、先知
蒙多	四费卡	试验品、统领
图奇	四费卡	试验品、狙神
艾克	四费卡	野火帮、极客、伏击专家
俄洛伊	四费卡	蓝发小队、哨兵
佐伊	四费卡	蓝发小队、法师
盖伦	四费卡	外交官、监察
莫德凯撒	五费卡	征服者、统领
凯特琳	五费卡	执法官、狙神
乐芙兰	五费卡	黑色玫瑰、法师
兰博	五费卡	机械公敌、极客、哨兵
赛薇卡	五费卡	搏击手、炼金男爵、百变铁手
杰斯	五费卡	皮城学院、双形战士
马尔扎哈	五费卡	海克斯机械、先知
金克斯	五费卡	蓝发小队、伏击专家
